11111111
11EC10C1
10101101
100P00C1
11111111