111111111
1PE000001
1111C0001
111111111